
11111111 111
1001010010001
1000010111001 
10000E0000001
1000110000011

1000110000001
1000110000001
1000011000101
100011001001
1011111111010
11111111101




 