11111111 111
1001010010001
1000010111001 
10000E0000001
    100011000111
1000110000001
1111110000001
110000110101
1111111001001
1011111111010
11111101101




