

111111111111
1001010000001
1000010111001 
10000E00000011
1000110000011
1000110000001
1000110000001
1000011000101
1000110010001
10111111111111
1111111110000
1




 