111111
                                                        11111111111111
                11111111111111111                       11000000000001
                100000000000000011111111111111111111111111000000000001
                100001100000000000000000000000000000000000000000000001
                100001100000000011111111111111111001111111111111011111
                10000110000000001               1001           101
                10000110000011111               1001           101111111111111111
                10000000N00000001               1001           100000000000000001
                10000000000000001           111110011111       111111111111111101
                10000000001111111           100000000001                      101
                10000000000000001           000000000001                      101
                10000000000000001111111111111000000000011111111111111111111111101
                10000000000000000000000000000000011110000000000000000000000000001
                11111011111111111111111111111000000000011111111111111111111111101
                    101                     100000000001                      101
                11111011111111111           100000000001                      101
                10000000000000001           111110011111                      101
                10000000000000001               1001                          101
                10000000011111111111111111111111100111111111111111111111111111101
                10000000000000000000000000000000000000000000000000000000000000001
                10000000000000001111111111111111111111111111111111111111111111111
                10000000000000001
                10000000000000001                                                                   1111
                10000000000000001                                                                   1001
                10000000000000001                                                                   1111
                10000000000000001111111111111
                10000000000000000000000000001
                11111111111111111111111111101
                                         11011
                                        11000111111111
11111111111111111                       11000000000001
100000000000000011111111111111111111111111000000000001
100000000000000000000000000000000000000000000000000001
100000000000000011111111111111111001111111111111011111
10000000000000001               1001           101
10000000000000001               1001           101111111111111111
10000000000000001               1001           100000000000000001
10000000000000001           111110011111       111111111111111101
10000000000000001           100000000001                      101
10000000000000001           100000000001                      101
10000000000000001111111111111000000000011111111111111111111111101111111111111111111111111111111111111111111111111111111111111111111111111111111111111111111111111111111
10000000000000000000000000000000000000000000000000000000000000000000000000000000000000000000000000000000000000000000000000000000000000000000000000000000000000000000001
11111011111111111111111111111000000000011111111111111111111111101111111111111111111111111111111111111111111111111111111111111111111111111111111111111111111111111111111
    101                     100000000001                      101
11111011111111111           100000000001                      101
10000000000000001           111110011111                      101
10000000000000001               1001                          101
10000000000000001111111111111111100111111111111111111111111111101
10000000000000000000000000000000000000000000000000000000000000001
10000000000000001111111111111111111111111111111111111111111111111
10000000000000001
10000000000000001
10000000000000001
10000000000000001
10000000000000001
10000000000000001
11111111111111111