NO ./assets/textures/stonewall_blue.png
SO ./assets/textures/stonewall_grey.png
WE ./assets/textures/brick_red.png
EA ./assets/textures/brick_purple.png
F 0,191,255
C 220,20,60

1111111111111111111111111
1000000000110000000000001
1011000001110000000000001
1001000000000000000000001
1111111110110000011100001
1000000000110000011101111
11110111111111011100000011111
11110111111111011101010010001
11000000110101011100000010001
100000000000000011011110N0111
11110111111101011101111010001
11111111 1111111 111111111111
