NO ./assets/textures/stonewall_blue.png
SO ./assets/textures/stonewall_grey.png
WE ./assets/textures/brick_red.png
EA ./assets/textures/brick_purple.png
F 220,100,0
C 255,255,255

1111111111111111111111111
1000000000000000000000001
10000000000000000N0000001
1000000000000000000000001
1111111111111111111111111