NO ./assets/textures/stonewall_blue.png
SO ./assets/textures/stonewall_grey.png
WE ./assets/textures/brick_red.png
EA ./assets/textures/brick_purple.png
F 220,100,0
C 255,255,255



1111111111111111 111111111
1000000000110000100000001
1011000001110000000000001
1001000000000000000000001
11111111101100000111000001
10000000001100000111011111111111
11110111111111011100000010001
11110111111111011101010010001
11000000110101011100000010001
10000000000000001100000010001
10000000000000001101010010001
11000001110101011111011110N0111
11110111 1110101 101111010001
11111111 1111111 11111111111
