NO ./assets/wolfenstein/brick_red.png
SO ./assets/wolfenstein/brick_red.png
WE ./assets/wolfenstein/brick_red.png
EA ./assets/wolfenstein/brick_red.png
F 0,0,0
C 0,0,0
111111
1000101
10000001
1N01111
101
1111