NO ./assets/wolfenstein/brick_red_512.png
SO ./assets/wolfenstein/brick_red_512.png
WE ./assets/wolfenstein/brick_red_512.png
EA ./assets/wolfenstein/brick_red_512.png
F 0,0,0
C 0,0,0
11111
1000111
10000001
1N00111
1000011
1111111