NO ./assets/wolf/brick_red_1024.png
SO ./assets/wolf/brick_blue_1024.png
WE ./assets/wolf/brick_green_1024.png
EA ./assets/wolf/brick_purple_1024.png
F 0,0,0
C 0,0,0
111111111111111
1E0000000000011
100000000000100
111000000001000
100000000000111
111111111111111